# war
#include <stdio.h>
#include <iostream>
#include <time.h>
#include <windows.h>





char matriz[35][49] =    {{'#','#','#','#','#','#','#',' ','#','#','#','#','#','#','#',' ','#','#','#','#','#','#','#',' ',' ',' ','#','#','#','#','#','#','#',' ','#','#','#','#','#','#','#',' ','#','#','#','#','#','#','#'},
                          {'#',' ',' ',' ',' ',' ','#','=','#',' ',' ',' ',' ',' ','#','=','#',' ',' ',' ',' ',' ','#','=','=','=','#',' ',' ',' ',' ',' ','#','=','#',' ',' ',' ',' ',' ','#','=','#',' ',' ',' ',' ',' ','#'},
                          {'#','G','H','A','N','A','#','=','#','B','E','N','I','N','#','=','#','H','A','I','T','I','#','=','=','=','#','C','H','I','N','A','#','=','#','J','A','P','A','N','#','=','#','M','A','C','A','O','#'},
                          {'#','#','#','#','#','#','#',' ','#','#','#','#','#','#','#',' ','#','#','#','#','#','#','#',' ',' ',' ','#','#','#','#','#','#','#',' ','#','#','#','#','#','#','#',' ','#','#','#','#','#','#','#'},
                          {' ',' ',' ','=',' ',' ',' ',' ',' ',' ',' ','=',' ',' ',' ',' ',' ',' ',' ','=',' ',' ',' ',' ',' ',' ',' ',' ',' ','=',' ',' ',' ',' ',' ',' ',' ','=',' ',' ',' ',' ',' ',' ',' ','=',' ',' ',' '},
                          {' ',' ',' ','=',' ',' ',' ',' ',' ',' ',' ','=',' ',' ',' ',' ',' ',' ',' ','=',' ',' ',' ',' ',' ',' ',' ',' ',' ','=',' ',' ',' ',' ',' ',' ',' ','=',' ',' ',' ',' ',' ',' ',' ','=',' ',' ',' '},
                          {'#','#','#','#','#','#','#',' ','#','#','#','#','#','#','#',' ','#','#','#','#','#','#','#',' ',' ',' ','#','#','#','#','#','#','#',' ','#','#','#','#','#','#','#',' ','#','#','#','#','#','#','#'},
                          {'#',' ',' ',' ',' ',' ','#','=','#',' ',' ',' ',' ',' ','#','=','#',' ',' ',' ',' ',' ','#','=','=','=','#',' ',' ',' ',' ',' ','#','=','#',' ',' ',' ',' ',' ','#','=','#',' ',' ',' ',' ',' ','#'},
                          {'#','S','U','D','A','N','#','=','#','E','G','Y','P','T','#','=','#','N','I','G','E','R','#','=','=','=','#','N','E','P','A','L','#','=','#','K','O','R','E','A','#','=','#','I','N','D','I','A','#'},
                          {'#','#','#','#','#','#','#',' ','#','#','#','#','#','#','#',' ','#','#','#','#','#','#','#',' ',' ',' ','#','#','#','#','#','#','#',' ','#','#','#','#','#','#','#',' ','#','#','#','#','#','#','#'},
                          {' ',' ',' ',' ',' ',' ',' ',' ',' ',' ',' ','=',' ',' ',' ',' ',' ',' ',' ',' ',' ',' ',' ',' ',' ',' ',' ',' ',' ',' ',' ',' ',' ',' ',' ',' ',' ','=',' ',' ',' ',' ',' ',' ',' ',' ',' ',' ',' '},
                          {' ',' ',' ',' ',' ',' ',' ',' ',' ',' ',' ','=',' ',' ',' ',' ',' ',' ',' ',' ',' ',' ',' ',' ',' ',' ',' ',' ',' ',' ',' ',' ',' ',' ',' ',' ',' ','=',' ',' ',' ',' ',' ',' ',' ',' ',' ',' ',' '},
                          {' ',' ',' ',' ',' ',' ',' ',' ',' ',' ',' ','=',' ',' ',' ',' ',' ',' ',' ',' ',' ',' ',' ',' ',' ',' ',' ',' ',' ',' ',' ',' ',' ',' ',' ',' ',' ','=',' ',' ',' ',' ',' ',' ',' ',' ',' ',' ',' '},
                          {' ',' ',' ',' ',' ',' ',' ',' ',' ',' ',' ','=',' ',' ',' ',' ',' ',' ',' ',' ',' ',' ',' ',' ',' ',' ',' ',' ',' ',' ',' ',' ',' ',' ',' ',' ',' ','=',' ',' ',' ',' ',' ',' ',' ',' ',' ',' ',' '},
                          {' ',' ',' ',' ',' ',' ',' ',' ',' ',' ',' ','=',' ',' ',' ',' ',' ',' ',' ',' ',' ',' ',' ',' ',' ',' ',' ',' ',' ',' ',' ',' ',' ',' ',' ',' ',' ','=',' ',' ',' ',' ',' ',' ',' ',' ',' ',' ',' '},
                          {' ',' ',' ',' ',' ',' ',' ',' ',' ',' ',' ','=',' ',' ',' ',' ',' ',' ',' ',' ',' ',' ',' ',' ',' ',' ',' ',' ',' ',' ',' ',' ',' ',' ',' ',' ',' ','=',' ',' ',' ',' ',' ',' ',' ',' ',' ',' ',' '},
                          {'#','#','#','#','#','#','#',' ','#','#','#','#','#','#','#',' ','#','#','#','#','#','#','#',' ',' ',' ','#','#','#','#','#','#','#',' ','#','#','#','#','#','#','#',' ','#','#','#','#','#','#','#'},
                          {'#',' ',' ',' ',' ',' ','#','=','#',' ',' ',' ',' ',' ','#','=','#',' ',' ',' ',' ',' ','#','=','=','=','#',' ',' ',' ',' ',' ','#','=','#',' ',' ',' ',' ',' ','#','=','#',' ',' ',' ',' ',' ','#'},
                          {'#','I','T','A','L','Y','#','=','#','N','A','U','R','U','#','=','#','P','A','L','A','U','#','=','=','=','#','Q','A','T','A','R','#','=','#','S','A','M','O','A','#','=','#','Y','E','M','E','N','#'},
                          {'#','#','#','#','#','#','#',' ','#','#','#','#','#','#','#',' ','#','#','#','#','#','#','#',' ',' ',' ','#','#','#','#','#','#','#',' ','#','#','#','#','#','#','#',' ','#','#','#','#','#','#','#'},
                          {' ',' ',' ','=',' ',' ',' ',' ',' ',' ',' ','=',' ',' ',' ',' ',' ',' ',' ','=',' ',' ',' ',' ',' ',' ',' ',' ',' ','=',' ',' ',' ',' ',' ',' ',' ','=',' ',' ',' ',' ',' ',' ',' ','=',' ',' ',' '},
                          {' ',' ',' ','=',' ',' ',' ',' ',' ',' ',' ','=',' ',' ',' ',' ',' ',' ',' ','=',' ',' ',' ',' ',' ',' ',' ',' ',' ','=',' ',' ',' ',' ',' ',' ',' ','=',' ',' ',' ',' ',' ',' ',' ','=',' ',' ',' '},
                          {'#','#','#','#','#','#','#',' ','#','#','#','#','#','#','#',' ','#','#','#','#','#','#','#',' ',' ',' ','#','#','#','#','#','#','#',' ','#','#','#','#','#','#','#',' ','#','#','#','#','#','#','#'},
                          {'#',' ',' ',' ',' ',' ','#','=','#',' ',' ',' ',' ',' ','#','=','#',' ',' ',' ',' ',' ','#',' ',' ',' ','#',' ',' ',' ',' ',' ','#','=','#',' ',' ',' ',' ',' ','#','=','#',' ',' ',' ',' ',' ','#'},
                          {'#','S','P','A','I','N','#','=','#','M','A','L','T','A','#','=','#','T','O','N','G','A','#',' ',' ',' ','#','S','Y','R','I','A','#','=','#','A','R','U','B','A','#','=','#','C','H','I','L','E','#'},
                          {'#','#','#','#','#','#','#',' ','#','#','#','#','#','#','#',' ','#','#','#','#','#','#','#',' ',' ',' ','#','#','#','#','#','#','#',' ','#','#','#','#','#','#','#',' ','#','#','#','#','#','#','#'},
                          {' ',' ',' ',' ',' ',' ',' ',' ',' ',' ',' ',' ',' ',' ',' ',' ',' ',' ',' ',' ',' ',' ',' ',' ',' ',' ',' ',' ',' ',' ',' ',' ',' ',' ',' ',' ',' ',' ',' ',' ',' ',' ',' ',' ',' ',' ',' ',' ',' '},
                          {' ',' ',' ',' ',' ',' ',' ',' ',' ',' ',' ',' ',' ',' ',' ',' ',' ',' ',' ',' ',' ',' ',' ',' ',' ',' ',' ',' ',' ',' ',' ',' ',' ',' ',' ',' ',' ',' ',' ',' ',' ',' ',' ',' ',' ',' ',' ',' ',' '},
                          {' ',' ',' ',' ',' ',' ',' ',' ',' ',' ',' ',' ',' ',' ',' ',' ',' ',' ',' ',' ',' ',' ',' ',' ',' ',' ',' ',' ',' ',' ',' ',' ',' ',' ',' ',' ',' ',' ',' ',' ',' ',' ',' ',' ',' ',' ',' ',' ',' '}};






void printarmapa (void){

for (int i=0;i<35;++i){
	for (int j=0;j<49;j++){
	   printf("%c", matriz[i][j]);
	} 
	printf("\n");
}
}

int main(){

system ("color 97");	
	
void printarmapa ();
printarmapa();	
	
	
	
return 0;
}
